"a" = (/turf/atom/TestWall,/area)
"b" = (/turf/atom/Ground/Grass,/area)
"c" = (/turf/atom/Ground/Grass,/turf/atom/Hole,/area)
"d" = (/turf/atom/DirtLow,/area)
"e" = (/turf/atom/Water,/area)
"f" = (/turf/atom/Ground/Dirt,/area)
"g" = (/turf/atom/Ground/Dirt,/turf/atom/Hole,/area)
"h" = (/turf/atom/Ground/Grass,/turf/atom/Hole,/turf/atom/Hole,/area)
"i" = (/turf/Special/ASMiscCaves/Cave01In,/area)
"j" = (/turf/atom/Ground/Grass,/turf/atom/Caves/Cave01In,/area)

(1,1,1) = {"
aaaaaaaaaaaaaeabbbbbbbbbbbbbbbbbbbbbbbbbbbbbbbbbbb
aaaaaaaaaaaeebebbbbbbbfbbbbbbbbbbbbbbbbbbbbbbbbbbb
aaaaaaaaaabeebeebbbbbfffbfbbbbbbbbbbbbbbbbbbbbbbbb
aaaaaaabbbbeeeeebbbbbffffbffbbbbbbbbbbbbbbbbbbbbbb
aaaaaaabbbbeeeeebbbbbffbbbbffbbbbfbbbbbbbbbbbbbbbb
aaaaaabbbbbeeeeebbbbbfffbbbbfbbbffbbbbbbbbbbbbbbbb
aaaaaabbbbbeeeeebbbbbbbbfbbbbfbfbffbbbbbbbbbbbbbbb
aaaaaabbbbbeeeeebbbbbbbbbffbbffbbbfbccbbbbbbbbbbbb
aaaaaabbbbbeeeeebbbbbbbbbbbfbffbfbfgcchcbbbbbbbbbb
aaaaaabbbbbeeeebbbbbfbbbbfbbbbffbbbgccccbbbbbbbbbb
abaaaabbbbbeeeebbbbbfbbfbbbbbffbfffbbcccbbbbbbbbbb
aaaaabbbbbbbebebbbfbfbffbbbbfbffbffbbccbbbbbbbbbbb
aaaaabbbbbbbebebbffbffbfbbbbbfbbfbbfbbbbbbbbbbbbbb
aaaabbbbbbbeeeebbfffffbfbbfffbbbbbbfbbbbbbbbbbbbbb
aaaabbbbbbbeeebbbfffffffbfbffbbbfbbfbbbbbfbbbbbbbb
aaabbbbbbbbeeeebbfffbfbffbbffbbbfbfbfbbbffbbbbbbbb
aabbbbbbbbeeebebffffffbffbbffbbbffbbbffbffffbbbbbb
abbbbbbbbbeeebebfffffffffbfbbfffffbfffffbffffbbbbb
abbbbbbbbbebebebbbbfffbfffbbbbbbbfffffffffbbffffbb
abbbbbbbbbebebebbbffbfffffbfbbbbbfbffbbffbbbffbffb
bbbbbbbbbbeeebebbbfffffbffbbbbfffbbffbfbffbffbbbff
bbbbbbbbbbeeebebbbbffbbiffbbbbbfffffffbfffbffbbfff
bbbbbbbbbbbeeeebbbbbffbbfffbbfffbfffbbbffbbfbbbfbf
bbbhcbbbbbbeeeebfbffffffffbbbfbffbffbbfbfbbfbbbbfb
bbchhbbbbbbeeebbfffbbbffbffbffbfffbbffbfbbbbfbbbbb
bbbchcbbbbbeeeebbbbbfffddddfddddfffffffbbbbbfbfbbb
bbhchcbbfbbeebbbbbffbfdddddddddddddddffbbbbffbbbbb
bbhcccbbbbbeeebbbbfdddddddddddddddddddffbbfbffbbbb
bbhcbcbfbbbeeebbbfdddddddddddddddddddddfddbfbfbbbb
bbbbbbfbbbbeeebbfdddddddddddddddddddddddddfbffbbbb
bbbbbbfbbbeeebbffbfdddddddddddddddddddddddddfbbbbb
bbbbbbfbbbeebbffffddddddddddddddddddddddddffbbbbbb
bbbbbbfbbbeebbfbffdddddddddddddddddddddddfffbfffbb
bbbbbbbfbeeebbbfffdddddddddddddddddddddddfffbbbbff
bbbbbbfbbeeebfffbfdddddddddddddddddddddddbbfbbjbbf
bbbbbbbbbeeebfffffdddddddddddddddddddddfbbffbbbbbf
bbeeeeeeeeeebfbbbbbfdddddddddddddddddbffbffbbbbffb
ebbeeeeeeeeebfffbfbbdddddddddddddddfffbffbbbbbfbbb
ebeeeeeeeeeebbbbbbbbbfbfddddddddddffbbbbbbbfbbbbbb
eeeeeeeeeeeeeeeebbfbbbbbbbdddddbbbfbbbbfbfbbbbbbee
beeeeeeeeeeeeebebbbbbbbbbbbbbbbbbbbfffbbbbbbbbeeee
eeeeeeeeeebbebeebbbbbbbbbbbbbbeeeebbbbbbbbbbeeeeee
eeeeeeeeeeeeeeeeebbbbbbbeebbbebbbebbbbbbbbbebeeeee
eeeeeeeeeeeeeeeeeeebbbbeeeebeeeeeebeeeeebbebeeeeee
eeeeeeeeeeeeeeebbeeeeebeebeebbeebeeebebbeeeeeeeeee
eeeeeeeeeeeeeeeeeeeeeeeeeeeeeeeeeeeeeeeeeeeeeeeeee
eeeeeeeeeeeeeeeeeeeeeeeeeeeeeeeeeeeeeeeeeeeeeeeeee
eeeeeeeeeeeeeeeeeeeeeeeeeeeeeeeeeeeeeeeeeeeeeeeeee
eeeeeeeeeeeeeeeeeeeeeeeeeeeeeeeeeeeeeeeeeeeeeeeeee
eeeeeeeeeeeeeeeeeeeeeeeeeeeeeeeeeeeeeeeeeeeeeeeeee
"}
