"a" = (/turf/atom/Underground{icon_state = "basalt9"},/area)
"b" = (/turf/atom/Ground/Grass,/area)
"c" = (/turf/atom/Water,/area)
"d" = (/turf/atom/TestWall,/area)
"e" = (/turf/atom/Ground/Dirt,/area)
"f" = (/turf/atom/WaterDeep,/area)
"g" = (/turf/Special/Blank,/turf/atom/WaterDeep,/area)
"h" = (/turf/atom/Lava,/area)
"i" = (/turf/Special/Blank,/turf/atom/Water,/area)

(1,1,1) = {"
aaaaaaaaaaaaaaaaaaaaaaaaaaaaaaaaaaaaaaaaaaaaaaaaaa
aaaaaaaaahhhhhhhhhhhhhhhhaaaaaaaaaaaaaaaaaaaaaahaa
haaaaaaaahhhhhhhhhhhhhhhhaaaaaaaaaaaaaaaaaaaaaahaa
aaaaaaaaahhhhhhhhhhhhhhhhaaaaaaaaaaaaaaaaaaaaaahaa
aaaaaaaaahhhhhhhhhhhhhhhhaaaaaaaaaaaaaaaaaaaaaahaa
aaaaaaaaahhhhhhhhhhhhhhhhaaaaaaaaaaaaaaaaaaaaaaaaa
aaaaaaaaaaaaaaaaaaaaaaaaaaaaaaaaaahhhhaaaaaaaaaaaa
aaaaaaahhhaaaaaaaaaaahhhhhhhaaaaaahhhhaaaaaaaaaaaa
aaaaaaahhhaaaaaaaaaaahhhhhhhaaaaaahhhhaaaaaaaaaaaa
aaaaaaahhhaaaaaaaaaaahhhhhhhaaaaaahhhhaaaaaaaaaaaa
aaaaaaaaaaaaaaaaaaaaahhhhhhhaaaaaahhhhaaaaaaaaaaaa
aaaaaaaaaaaaaaaaaaaaahhhhhhhaaaaaahhhhaaaaaaaaaaaa
aaaaaaaaaaaaaaaaaaaaaaaaaaaaaaaaaahhhhaaaaaaaaaaaa
aaaaaaaaaaaaaaaaaaaaaaaaaaaaaaaaaaaaaaaaaaaaaaaaaa
aaaaaaaaaaaaaaaaaaaaaaaaaaaaaaaaaahhhhhhaaaaaaaaaa
aaaaaaaaaaaaaaaaaaaaaaaaaaaaaaaaaahhhhhhaaaaaaaaaa
aaaaaahhaaaaaaaaaaaaaaaaaaaaaaaaaahhhhhhaaaaaaaaaa
aaaaaahhaaaaaaaaaaaaaaaaaaaaaaaaaahhhhhhaaaaaaaaaa
aaaaaahhaahaaaaaaaaaaaaaaaaaaaaaaahhhhhhaaaaaaaaaa
aaaaaahhaahaaaaaaaaaaahhhhhhaaaaaahhhhhhaaaaaaaaaa
aaaaaaaaaahaaaaaaaaaaahhhhhhaaaaaahhhhhhaaaaaaaaaa
aaaahhhaaahaaaaaaaaaaaaaaaaaaaaaaaaaaaaaaaaaaaaaaa
aaaahhhaaahaaaaaaaaaaaaaaaaaaaaaaaaaaaaaaaaaaaaaaa
aaaahhhaaaaaaaaaaaaaaaaaaaaaaaaaaaaaaaaaaaaaaaaaaa
aaaahhhaaaaaaaaaaaaaaaaaaaaaaaaaaaaaaaaaaaaaaaaaaa
aaaahhhaaaaaaaaaaaaaaaaaahhhhhhhhhaaaaaaaaaaaaaaaa
aaaahhhaaaaaaaaaaaaaaaaaahhhhhhhhhaaaaaaaahhaaaaaa
aaaahhhaaaaaaaaaaaahhhhaahhhhhhhhhaaaaaaaahhaaaaaa
aaaaaaaaahhhhaaaaaahhhhaahhhhhhhhhaaaaaaaahhaaaaaa
aaaaaaaaahhhhaaaaaahhhhaaaaaaahhhhaaaaaaaahhaaaaaa
aaaaaaaaahhhhaaaaaahhhhaaaaaaahhhhaaaaaaaahhaaaaaa
aaaaaaaaaaaaaaaaaaahhhhaaaaaaahhhhaaaaaaaaaaaaaaaa
aaahhaaaaaaaaaaaaaahhhhaaaaaaahhhhaaaaaaaaaaaaaaaa
aaahhaaahhaaaaaaaaahhhhaaaaaaahhhhaaaaaaaaaaaaaaaa
aaahhaaahhaaaaaaaaaaaaaaaaaaaaaaaaaaaaaaaaaaaaaaaa
aaahhaaahhaaaaaaaaaaaaaaaaaaaaaaaaaaaaahhhaaaaaaaa
aaahhaaahhaaaaaaaahhhhhhaaaaaaaaaaaaaaahhhaaaaaaaa
aaahhaaahhaaaahaaahhhhhhaaaaaaaaaaaaaaahhhaaaaaaaa
aaahhaaaaaaaaaaaaaaaaaaaaaaaaaaaaaaaaaaaaaaaaaaaaa
aaaaaaaaaaaaaaaaaaaaaaaaaaaaaaaaaaaaaaaaaaaaaaaaaa
aaaaaaaaaaaaaaaaaaaaaaaaaaaaaaaaaaaaaaaaaaaaaaaaaa
aaaaaaaaaaaaaaaaaaaaaaaaaaaahaaaaaaaaaaaaaaaaaaaaa
aaaaaaaaaaaaaahhhaaaaaaaaaaaaaaaaaaaaaahhhaaaaaaaa
aaaaaaaaaaaaaahhhaaaaaaaaaaaaaaaaaaaaaahhhhhhhhhaa
aaaaaaahhhaaaaaaaaaaaaaaaaaaaaaaaaaaaaahhhhhhhhhaa
aaaaaaahhhaaaaaaaaaaaaaaaaaaaaaaaaaaaaahhhhhhhhhaa
aaaaaaahhhaaaaaaaaaaaaaaaaaaaaaaaaaaaaahhhhhhhhhha
aaaaaaahhhaaahhhhhhhaaaaaaaaaaaaaaaaaaahhhhhhhhhha
aaaaaaaaaaaaahhhhhhhaaaaaaahhhhhhhhhaaaaaaaaaaaaaa
aaaaaaaaaaaaaaaaaaaaaaaaaaahhhhhhhhhaaaaaaaaaaaaaa
"}

(1,1,2) = {"
cccccccccccccccccccccccccccbcccccccccccccccccccccc
cccccccccccccccbbccccccbbccbccccbcccbccccccccccccc
cccccccccccbccccccccccccddbccccccbbccccccccccccccc
ccccccccccccbccbbbbcdddddddceecbccbbbbcccccccdcccc
cccccccddddcdbbdddddddddddddddbcccbbbbcccccccccccc
ccccccccdddddbddddddddddddddddddcceebbcecccccccccc
ccccccddddddddddddddddddddddddddddddddcccccccccccc
ccccccdddddddddddcdcceeccddcddddcdbddddeecdccccccc
ccccccddddddddddccccceecccddddddddddddddddddcccccc
cccccccddddddcccccccceeccccdddddddddddddeddcdccccc
cccccccddddddbbbbeebbbbbbbbbdddddddddddddcddbccccc
cccccccdddddddbbbeebbbbbbbbbbbbbddddddddddddcccccc
ccccccdddddddbbbbeeeebbbbbbbbbbbbbbbbdbdddddcccccc
cccccddddddddbbbbbbeebbbbbbbbbbbbbbbbdddddddcccccc
cccccddddbbbbbbbbbbbbeeeeebbbbbbbbbbbddbddddddcccc
ccccccdddbbbbbbbbbbeeeeeeebbbbbbeeeeedebbdddbdbccc
ccccccddcbbbbbbbeeeeeeeeeeeeebeeeeeeeeeebddddbbccc
cccccccccbeeeeeeeeeeeeeeeeeeebeeeeeeeeeebddddbcccc
cccbbbbbeeeeeeeeeeeeeeeeeeeebbbbddeeeeeeddddbbcccc
cccbbbeeeeeeeeeeeeeeeeeeebbbbbbbddbbbbeeddddbccccc
ccbbbbeeeeeeebbbbbbbbbbbbbbbbbbbddbbbbedddddbccccc
ccbbbbeeeeeebbbbbbbbbbbbbbbbbbbbddbbbbdddddccccccc
ccbbbbeeeeeebbbbbbbbbbbbbbbbbbbbdddddddddddccccccc
ccbbbbeeeeeeeccccccccccccccccccccddddddccccccccccc
cceebbeeeeeeeecccccccccccccccccccdddddcccccccccccc
cceebbeeeeeeeeeccccccccccccccccccccccccccccccccccc
cceebbeeeeeeeeeecccccccccccccccccccccccccccccccccc
ccbcbbeeeeeeeeeeeecccccccccccccccccccccccccccccccc
ccbcbbeeeeeeeeeeeeeeeecccccccccccccccccccccccccccc
cccbbbeeeeeeeeeeeeeeeecccccccccccccccccccccccccccc
ccbbbbeeeeeeeeeeeeeeeeeccccccccccccccccccccccccccc
cbcbbbbeeeeeeeeeeeeeeeeeccbbbbbbbbcccccbbbbccccccc
cccbbbbeeeeeeeeeeeeeeeeebbbbbbbbbbbbbccbbbbccccccc
cccbbbbeeeeeeeeeeeeeeeeeeebbbbbbbbbbbbbbbbbccccccc
ccbbbbbbeeeeeeeeeeeeeeeeeeeebbbbbbbbbbbbbbcccccccc
ccbcbbbbeeeeeeeeeeeeeeeeeeeebbbbbbbbbbbbbccccccccc
ccbccbbbbeeeeeeeeeeeeeeeeeeeebbbbbbbbbbbbccccccccc
cccccbbbbbbbbbbbbbbbbbbbbbbeeeebbbbbbbbbbccccccccc
cccccccbbbbbbbbbbbbbbbbbbbbbbbbbbbbbbbbbbccccccccc
cccccbcbbbbbbbbbbbbbbbbbbbbbbbbbbbbbbbbbbccccccccc
ccccccccbbbbbbbbbbbbbbbbbbbbbbbbbbbbbbbbbccccccccc
cccccccccbbbbccccccccbbbbbbbbbbbbbbccbbbbccccccccc
ffffccccccbbbccbbbcbbbcbccccccbbbbbbbbbbbccccccccc
fgffcccccciccccccccccccccccbbbbbbbbbbbbbcccccccccc
ffffcccccccccccccccccccccbcbbbbbbbbbbccccccccccccc
ffffcccccccccccccccccccccbcbbbbbbbbbcccccccccccccc
ffffcccccccccccccccccccccccccbccbccccccccccccccccc
ffffcccccccccccccccccccccccccccccccccccccccccccccc
ffffffffffffffffffffffffffffffffffffffffffffffffff
ffffffffffffffffffffffffffffffffffffffffffffffffff
"}
