"a" = (/turf/atom/TestWall,/area)
"b" = (/turf/atom/Dirt,/area)
"c" = (/turf/atom/Grass,/area)

(1,1,1) = {"
bbbbbbbbbbbbbbbbbbbbbbbbbbbbbbbbbbbbbbbbbbbbbbbbbbbbbbbbbbbbbbbbbbbbbbbbbbbbbbbbbbbbbbbbbbbbbbbbbbbb
bbbbbbbbbbbbbbbbbbbbbbbbbbbbbbbbbbbbbbbbbbbbbbbbbbbbbbbbbbbbbbbbbbbbbbbbbbbbbbbbbbbbbbbbbbbbbbbbbbbb
bbbbbbbbbbbbbbbbbbbbbbbbbbbbbbbbbbbbbbbbbbbbbbbbbbbbbbbbbbbbbbbbbbbbbbbbbbbbbbbbbbbbbbbbbbbbbbbbbbbb
bbbbbbbbbbbbbbbbbbbbbbbbbbbbbbbbbbbbbbbbbbbbbbbbbbbbbbbbbbbbbbbbbbbbbbbbbbbbbbbbbbbbbbbbbbbbbbbbbbbb
bbbbbbbbbbbbbbbbbbbbbbbbbbbbbbbbbbbbbbbbbbbbbbbbbbbbbbbbbbbbbbbbbbbbbbbbbbbbbbbbbbbbbbbbbbbbbbbbbbbb
bbbbbbbbbbbbbbbbbbbbbbbbbbbbbbbbbbbbbbbbbbbbbbbbbbbbbbbbbbbbbbbbbbbbbbbbbbbbbbbbbbbbbbbbbbbbbbbbbbbb
bbbbbbbbbbbbbbbbbbbbbbbbbbbbbbbbbbbbbbbbbbbbbbbbbbbbbbbbbbbbbbbbbbbbbbbbbbbbbbbbbbbbbbbbbbbbbbbbbbbb
bbbbbbbbbbbbbbbbbbbbbbbbbbbbbbbbbbbbbbbbbbbbbbbbbbbbbbbbbbbbbbbbbbbbbbbbbbbbbbbbbbbbbbbbbbbbbbbbbbbb
bbbbbbbbbbbbbbbbbbbbbbbbbbbbbbbbbbbbbbbbbbbbbbbbbbbbbbbbbbbbbbbbbbbbbbbbbbbbbbbbbbbbbbbbbbbbbbbbbbbb
bbbbbbbbbbbbbbbbbbbbbbbbbbbbbbbbbbbbbbbbbbbbbbbbbbbbbbbbbbbbbbbbbbbbbbbbbbbbbbbbbbbbbbbbbbbbbbbbbbbb
bbbbbbbbbbbbbbbbbbbbbbbbbbbbbbbbbbbbbbbbbbbbbbbbbbbbbbbbbbbbbbbbbbbbbbbbbbbbbbbbbbbbbbbbbbbbbbbbbbbb
bbbbbbbbbbbbbbbbbbbbbbbbbbbbbbbbbbbbbbbbbbbbbbbbbbbbbbbbbbbbbbbbbbbbbbbbbbbbbbbbbbbbbbbbbbbbbbbbbbbb
bbbbbbbbbbbbbbbbbbbbbbbbbbbbbbbbbbbbbbbbbbbbbbbbbbbbbbbbbbbbbbbbbbbbbbbbbbbbbbbbbbbbbbbbbbbbbbbbbbbb
bbbbbbbbbbbbbbbbbbbbbbbbbbbbbbbbbbbbbbbbbbbbbbbbbbbbbbbbbbbbbbbbbbbbbbbbbbbbbbbbbbbbbbbbbbbbbbbbbbbb
bbbbbbbbbbbbbbbbbbbbbbbbbbbbbbbbbbbbbbbbbbbbbbbbbbbbbbbbbbbbbbbbbbbbbbbbbbbbbbbbbbbbbbbbbbbbbbbbbbbb
bbbbbbbbbbbbbbbbbbbbbbbbbbbbbbbbbbbbbbbbbbbbbbbbbbbbbbbbbbbbbbbbbbbbbbbbbbbbbbbbbbbbbbbbbbbbbbbbbbbb
bbbbbbbbbbbbbbbbbbbbbbbbbbbbbbbbbbbbbbbbbbbbbbbbbbbbbbbbbbbbbbbbbbbbbbbbbbbbbbbbbbbbbbbbbbbbbbbbbbbb
bbbbbbbbbbbbbbbbbbbbbbbbbbbbbbbbbbbbbbbbbbbbbbbbbbbbbbbbbbbbbbbbbbbbbbbbbbbbbbbbbbbbbbbbbbbbbbbbbbbb
bbbbbbbbbbbbbbbbbbbbbbbbbbbbbbbbbbbbbbbbbbbbbbbbbbbbbbbbbbbbbbbbbbbbbbbbbbbbbbbbbbbbbbbbbbbbbbbbbbbb
bbbbbbbbbbbbbbbbbbbbbbbbbbbbbbbbbbbbbbbbbbbbbbbbbbbbbbbbbbbbbbbbbbbbbbbbbbbbbbbbbbbbbbbbbbbbbbbbbbbb
bbbbbbbbbbbbbbbbbbbbbbbbbbbbbbbbbbbbbbbbbbbbbbbbbbbbbbbbbbbbbbbbbbbbbbbbbbbbbbbbbbbbbbbbbbbbbbbbbbbb
bbbbbbbbbbbbbbbbbbbbbbbbbbbbbbbbbbbbbbbbbbbbbbbbbbbbbbbbbbbbbbbbbbbbbbbbbbbbbbbbbbbbbbbbbbbbbbbbbbbb
bbbbbbbbbbbbbbbbbbbbbbbbbbbbbbbbbbbbbbbbbbbbbbbbbbbbbbbbbbbbbbbbbbbbbbbbbbbbbbbbbbbbbbbbbbbbbbbbbbbb
bbbbbbbbbbbbbbbbbbbbbbbbbbbbbbbbbbbbbbbbbbbbbbbbbbbbbbbbbbbbbbbbbbbbbbbbbbbbbbbbbbbbbbbbbbbbbbbbbbbb
bbbbbbbbbbbbbbbbbbbbbbbbbbbbbbbbbbbbbbbbbbbbbbbbbbbbbbbbbbbbbbbbbbbbbbbbbbbbbbbbbbbbbbbbbbbbbbbbbbbb
bbbbbbbbbbbbbbbbbbbbbbbbbbbbbbbbbbbbbbbbbbbbbbbbbbbbbbbbbbbbbbbbbbbbbbbbbbbbbbbbbbbbbbbbbbbbbbbbbbbb
bbbbbbbbbbbbbbbbbbbbbbbbbbbbbbbbbbbbbbbbbbbbbbbbbbbbbbbbbbbbbbbbbbbbbbbbbbbbbbbbbbbbbbbbbbbbbbbbbbbb
bbbbbbbbbbbbbbbbbbbbbbbbbbbbbbbbbbbbbbbbbbbbbbbbbbbbbbbbbbbbbbbbbbbbbbbbbbbbbbbbbbbbbbbbbbbbbbbbbbbb
bbbbbbbbbbbbbbbbbbbbbbbbbbbbbbbbbbbbbbbbbbbbbbbbbbbbbbbbbbbbbbbbbbbbbbbbbbbbbbbbbbbbbbbbbbbbbbbbbbbb
bbbbbbbbbbbbbbbbbbbbbbbbbbbbbbbbbbbbbbbbbbbbbbbbbbbbbbbbbbbbbbbbbbbbbbbbbbbbbbbbbbbbbbbbbbbbbbbbbbbb
bbbbbbbbbbbbbbbbbbbbbbbbbbbbbbbbbbbbbbbbbbbbbbbbbbbbbbbbbbbbbbbbbbbbbbbbbbbbbbbbbbbbbbbbbbbbbbbbbbbb
bbbbbbbbbbbbbbbbbbbbbbbbbbbbbbbbbbbbbbbbbbbbbbbbbbbbbbbbbbbbbbbbbbbbbbbbbbbbbbbbbbbbbbbbbbbbbbbbbbbb
bbbbbbbbbbbbbbbbbbbbbbbbbbbbbbbbbbbbbbbbbbbbbbbbbbbbbbbbbbbbbbbbbbbbbbbbbbbbbbbbbbbbbbbbbbbbbbbbbbbb
bbbbbbbbbbbbbbbbbbbbbbbbbbbbbbbbbbbbbbbbbbbbbbbbbbbbbbbbbbbbbbbbbbbbbbbbbbbbbbbbbbbbbbbbbbbbbbbbbbbb
bbbbbbbbbbbbbbbbbbbbbbbbbbbbbbbbbbbbbbbbbbbbbbbbbbbbbbbbbbbbbbbbbbbbbbbbbbbbbbbbbbbbbbbbbbbbbbbbbbbb
bbbbbbbbbbbbbbbbbbbbbbbbbbbbbbbbbbbbbbbbbbbbbbbbbbbbbbbbbbbbbbbbbbbbbbbbbbbbbbbbbbbbbbbbbbbbbbbbbbbb
bbbbbbbbbbbbbbbbbbbbbbbbbbbbbbbbbbbbbbbbbbbbbbbbbbbbbbbbbbbbbbbbbbbbbbbbbbbbbbbbbbbbbbbbbbbbbbbbbbbb
bbbbbbbbbbbbbbbbbbbbbbbbbbbbbbbbbbbbbbbbbbbbbbbbbbbbbbbbbbbbbbbbbbbbbbbbbbbbbbbbbbbbbbbbbbbbbbbbbbbb
bbbbbbbbbbbbbbbbbbbbbbbbbbbbbbbbbbbbbbbbbbbbbbbbbbbbbbbbbbbbbbbbbbbbbbbbbbbbbbbbbbbbbbbbbbbbbbbbbbbb
bbbbbbbbbbbbbbbbbbbbbbbbbbbbbbbbbbbbbbbbbbbbbbbbbbbbbbbbbbbbbbbbbbbbbbbbbbbbbbbbbbbbbbbbbbbbbbbbbbbb
bbbbbbbbbbbbbbbbbbbbbbbbbbbbbbbbbbbbbbbbbbbbbbbbbbbbbbbbbbbbbbbbbbbbbbbbbbbbbbbbbbbbbbbbbbbbbbbbbbbb
ccccccccccccccccccccccccccccccccccccccccccccccccccccccccccccccccccccccccccccccccccccccccccccccccccbb
ccccccccccccccccccccccccccccccccccccccccccccccccccccccccccccccccccccccccccccccccccccccccccccccccccbb
ccccccccccccccccccccccccccccccccccccccccccccccccccccccccccccccccccccccccccccccccccccccccccccccccccbb
ccccccccccccccccccccccccccccccccccccccccccccccccccccccccccccccccccccccccccccccccccccccccccccccccccbb
ccccccccccccccccccccccccccccccccccccccccccccccccccccccccccccccccccccccccccccccccccccccccccccccccccbb
ccccccccccccccccccccccccccccccccccccccccccccccccccccccccccccccccccccccccccccccccccccccccccccccccccbb
ccccccccccccccccccccccccccccccccccccccccccccccccccccccccccccccccccccccccccccccccccccccccccccccccccbb
ccccccccccccccccccccccccccccccccccccccccccccccccccccccccccccccccccccccccccccccccccccccccccccccccccbb
ccccccccccccccccccccccccccccccccccccccccccccccccccccccccccccccccccccccccccccccccccccccccccccccccccbb
ccccccccccccccccccccccccccccccccccccccccccccccccccccccccccccccccccccccccccccccccccccccccccccccccccbb
ccccccccccccccccccccccccccccccccccccccccccccccccccccccccccccccccccccccccccccccccccccccccccccccccccbb
ccccccccccccccccccccccccccccccccccccccccccccccccccccccccccccccccccccccccccccccccccccccccccccccccccbb
ccccccccccccccccccccccccccccccccccccccccccccccccccccccccccccccccccccccccccccccccccccccccccccccccccbb
ccccccccccccccccccccccccccccccccccccccccccccccccccccccccccccccccccccccccccccccccccccccccccccccccccbb
cccccccccccccccccccccccccccccccccccccccccacccaccccccccccccccccccccccccccccccccccccccccccccccccccccbb
ccccccccccccccccccccccccccccaaccccccaaccaccccccaacccccccccccccccccccccccccccccccccccccccccccccccccbb
ccccccccccccccccccccacaacccccacaccaaacacccccccccacaaccacccccccccccccccccccccccccccccccccccccccccccbb
ccccccccccccccccccacccccacaccaccaaccacccaccccaaccccaccccacccccccccccccccccccccccccccccccccccccccccbb
cccccccccccccccccaccccccacccaccaaaccaccccccaccccaaaaaaccacccccccccccccccccccccccccccccccccccccccccbb
ccccccccccccccccaccccaaaacacaaaaaaaccccacccacacacaccccaaccccccccccccccccccccccccccccccccccccccccccbb
ccccccccccccccccaaacacacccccaaaaaacacaacaaaaaaacccaccaaaacccacccccccccccccccccccccccccccccccccccccbb
cccccccccccccccaacaaaacaaccaaacaaaaaaaccaaacccaaaacacaaacaaccaccccccccccccccccccccccccccccccccccccbb
ccccccccccccccaccaaaccacaaaacaacacaaaaaaaaaacaaaaaaaaaaccaaccaccccccccccccccccccccccccccccccccccccbb
ccccccccccccccacaccaccaaacaaaaaaaaaacaacaaaaaaaaaaaaaaacaaacaacccaacccccccccccccccccccccccccccccccbb
ccccccccccccccaaacccaaacaaaaaaaaaaacaaaaccaccaaacacaaaaaaaaacacaccacccccccccccccccccccccccccccccccbb
cccccccccaaccacaccaaaaaaaaaaccccccccaccaaaaaaaaaaaaaaacccaaaacacaaccccccccccccccccccccccccccccccccbb
ccccccccaccaacccaaaaaaaaaacacaccacaccccccccccaaaaaaaaaaaaaaaaccccacccccccaccccccccccccccccccccccccbb
cccccccacccaaccaaaaaaacacccccccccccccccccbccccccabaacacaaaccaccccaacaccaccacccccccccccccccccccccccbb
cccccccaacacaaaaaaaaaabccccccbcccccccbccccccccccccaaaaaaaaaccccacccccccccaccccccccccccccccccccccccbb
cccccccccaccacaaaaaacccccccccccbbccccbcccccccccccccaaaaaaaaacccaacaaacacacccccccccccccccccccccccccbb
cccccccccaaaaaaaaaacaccccccccccccbccccccbcbcccbcccccaacaaaaaacaaacacacccccccccccccccccccccccccccccbb
cccccccacaaaaaaaaacacccccbccbccccccccbbcbccccbccccccccacaaaaaaacccacaaacccccccccccccccccccccccccccbb
ccccccccaaaaaaaaacaccccccccccccbbbbbccccccbcccccbcbccccaaaaaaaaaacaacccaacccccccccccccccccccccccccbb
ccccccaaaaaaaaaaaaccccccccbcbcccbccccbbbcbbbbbbbbbccccccaacaaaaaacaacccaccccccccccccccccccccccccccbb
ccccccacaacaaaaaaacccccbcccbbbbbcbccbbbbcbccbcccbccbccccaaccaaaaaaaaaacccaccccccccccccccccccccccccbb
cccccaaaaaaaaaaaaccccccccbcbcbcbccccccccbcbccbcbccccbccccacaaaacaaaaacacccccccccccccccccccccccccccbb
cccccacaacaaaaaaacccccbcccbbccccccbccccccccbccccccccbbbcccaacaaaaaacacacacacccccccccccccccccccccccbb
ccccaccaaaaaaaaaccccccccccbcbccccbbbbcccbcbcbbbbcbbbbccccaaaaaaaaaaaaacaaacccaccccccccccccccccccccbb
cccccccaaaacaaabcccbcbcccbcbcbbcccccccccccbbbbcbccbccbbbcccaaaaaaaaaaccaaacccccaccccccccccccccccccbb
ccccacacaaaaacaccccccbcbbccccbccbcccccccbcbbcccbbccbccccbcaacaaaaaaaaacacaacccccccccccccccccccccccbb
ccccccacaaaacaaccbcccbccccbccccbbccbcbccbcccbcbccbccccccccaacaaaaaaaaacaaaacccccccccccccccccccccccbb
cccccaaaaaaacaacccbcbcccbcbbccbcccccccbcbbccbbccccccbcbcccaaaaaaaaaaaacaccacccacccccccccccccccccccbb
cccccaaaaaaacaaccccbcccccbbcbbbbcccccccccbcbbcbbbccccccbccaaaaaaaaaaaaaaaaaacaacccccccccccccccccccbb
cccccacaaaaacaabccccccbcbbcbcbbbbbccbcbccbccccbccccbcccccccacaaaaaacaaaacacaccccccccccccccccccccccbb
cccccaacaaaacaaccccccccbcbbbbbccbbccbcbccbcbcbbccbccbcbcccaaaaaaaaacaacaaaacacacccccccccccccccccccbb
cccccaaacaaaccabcccbcccccbbccbcbcbccbcccbcbcccccccccccccccaaaaaaaaaacacacaccccccccccccccccccccccccbb
cccccaaacaaaccaacccccccccbbccbbbcbbcccbccbbcccccccccbcccbcaaaaacaaaacacaaaccacccccccccccccccccccccbb
accccaaacaaaacabccccbcccccbbccbccbcccccccbbccbccccbcccccccacaaaaaacaaaaaaaccccccccccccccccccccccccbb
aaaacaacaaaaacaabbccccbcccbcccccccbbbcbccccccccbcccccccbcaaaaaacaccaccaaacccccccccccccccccccccccccbb
accacaaaaaaaaaaaaaccccccccccbcbbccbcbccccccccccccccccccccaaaaacaaacaaaccacccccccccccccccccccccccccbb
acaccaacccaaaaaacaacccccccbccccbbbbcccccccccbccccccccccccacaaaaaaaaaaaacaaccccccccccccccccccccccccbb
cccccaaaacaaaaaaaaaccbccccbcbccccccccbcccccccbccccccbcccaaaaacaaaaaacaacaaccccccccccccccccccccccccbb
ccccccacaacaaaaaaaaaacbbcccbbccbcccbcbbcbbcccbcccccccccaaaaaaaaaccaaacaaaaccccccccccccccccccccccccbb
ccccccacaaccaacaaaacaaaccccccbcbbcccbccccbbccccbccccccaaaaaaaaaaaaaaaaaccaccccccccccccccccccccccccbb
cccccccccaaccaacaaaaaaaaacccccccbccccbccccccccccccccccaaaaaacaaaacaccaccaaccccccccccccccccccccccccbb
cccccccccacaccaaaaaaaaaaaaaacccccccbcccbcccccccccccccaaaaaaacaccccaccaaaccccccccccccccccccccccccccbb
ccccccccccccaaaaaaaaaaaaaaaaaaaaacacccccccccccccccaaaaaaacaaacaaaacaaccaccccccccccccccccccccccccccbb
cccccccccccccccaaaaaaaaaaaaaaaaaaaaaaaaaaaaaaaaaaaaaaaaaacaaccaaacaaaaccccccccccccccccccccccccccccbb
cccccccccccccccccccccccaaaaaaaaaaaaaaaaaaaaaaaaaaaaaaaaacaaacaaaaacaccccccccccccccccccccccccccccccbb
"}
