"a" = (/turf/atom/Underground,/area)
"b" = (/turf/atom/Lava,/area)
"c" = (/turf/atom/Underground,/turf/atom/Caves/Cave01Out,/area)

(1,1,1) = {"
aaaaaaaaaaaaaaaaaaaaaaaaaaaaaaaaaabbbbaaaaaaaaaaab
aaaaaaaaaaaaaaaaaaaaaaaaaaaaaaaaaabaaabbaaaabbbbba
aaaaaaaaaaaaaaaaaaaaaaaaaaaaaaaaaaabbbaabaaabbbbba
aaaaaaaaaaaaaaaaaaaaaaaaaaaaaaaaaaabbbbbbbbbabaaba
aaaaaaaaaaaaaacaaaaaaaaaaaaaaaaaaabbaabbaabaaabbbb
aaaaaaaaaaaaaaaaaaaaaaaaaaaaaaaaaabaabbaaaabaaaabb
aaaaaaaaaaaaaaaaaaaaaaaaaaaaaaaaaabaabaabbbbbbabab
aaaaaaaaaaaaaaaaaaaaaaaaaaaaaaaaaabbbbbbaaaabbbaab
aaaaaaaaaaaaaaaaaaaaaaaaaaaaaaaaaaaaaabbbbbbbbbaab
aaaaaaaaaaaaaaaaaaaaaaaaaaaaaaaaaaaaaaababaaabbaab
aaaaaaaaaaaaaaaaaaaabbbbbbbbbaaaaaaaaaaabbbbabbbba
aaaaaaaaaaaaaaaaaaaabbbbbbbbbaaaaaaaaaaaaabaaabbaa
aaaaaaabbbbbbaaaaaaabbbbbbbbbaaaaaaaaaaaaaababbaaa
aaaaaaabbbbbbaaaaaaabbbbbbbbbaaaaaaaaaaaaaaabbbbaa
aaaaaaabbbbbbaaaaaaabbbbbbbbbaaaaaaaaaaaaaaabbabaa
aaaaaaabbbbbbaaaaaaaaaaaaaaaaaaaaaaaaaaaaaabababba
aaaaaaabbbbbbaaaaaaaaaaaaaaaaaaaaaaaaaaaaaababbaba
aaaaaaabbbbbbaaaaaaaaaaaaaaaaaaaaaaaaaaaaaabaababb
aaaaaaabbbbbbaaaaaaaaaaaaaaaaaaaaaaaaaaaaaabbabaaa
aaaaaaaaaaaaaaaaaaaaaaaaaaaaaaaaaaaaaaaaaaaabbbaaa
aaaaaaaaaaaaaaaaaaaaaaaaaaaaaaaaaaaaaaaaaaaaaaaaaa
aaaaaaaaaaaaaaaaaaaaaaaaaaaaaaaaaaaaaaaaaaaaaaaaaa
aaaaaaaaaaaaaaaaaaaaaaaaaaaaaaaaaaaaaaaaaaaaaaaaaa
aaaaaaaaaaaaaaaaaaaaaaaaaaaaaaaaaaaaaaaaaaaaaaaaaa
aaaaaaaaaaaaaaaaaaaaaaaaaaaaaaaaaaaaaaaaaaaaaaaaaa
aaaaaabbbaaaaaaaaaaaaaaabaaaaaaaaaaaaaaaaaaaaaaaaa
aaaaaabbbaaaaaaaaaaaaaaaaaaaaaaaaaaaaaaaaaaaaaaaaa
aaaaaabbbaaaaaaaaaaaaaaaaaaaaaaaaaaaaaaaaaaaaaaaaa
aaaaaabbbaaaaaaaaaaaaaaaaaaaaaaaaaaabbbbaaaaaaaaaa
aaaaaabbbaaaaaaaaaaaaaaaaaaaaaaaaaaabbbbaaaaaaaaaa
aaaaaabbbaaaaaaaaaaaaaaaaaaaaaaaaaaabbbbaaaaaaaaaa
aaaaaabbbaaaaaaaaaaaaaaaaaaaaaaaaaaabbbbaaaaaaaaaa
aaaaaabbbaaaaaaaaaaaaaaaaaaaaaaaaaaabbbbaaaaaaaaaa
aaaaaabbbaaaaaaaaaaaaabbaaaaaaaaaaaabbbbaaaaaaaaaa
aaaaaabbbaaaaaaaaaaaaabbaaaaaaaaaaaaaaaaaaaaaaaaaa
aaaaaabbbaaaaaaaaaaaaaaaaaaaaaaaaaaaaaaaaaaaaaaaaa
aaaaaabbbaaaaaaaaaaaaaaaaaaaaaaaaaaaaaaaaaaaaaaaaa
aaaaaabbbaaaaaaaaaaaaaaaaaaaaaaaaaaaaaaaaaaaaaaaaa
aaaaaabbbaaaaaaaaaaaaaaaaaaaaaaaaaaaaaaaabbaaaaaaa
aaaaaaaaaaaaaaaaaaaaaaaaaaaaaaaaaaaaaaaaabbaaaaaaa
aaaaaaaaaaaaaaaaaaaaaaaaaaaaaaaaaaaaaaaaaaaaaaaaaa
aaaaaaaaaaaaaaaaaaaaaaaaaaaaaaaaaaaaaaaaaaaaaaaaaa
aaaaaaaaaaaaaaaaaaaaaaaaaaaaaaaaaaaaaaaaaaaaaaaaaa
aaaaaaaaaaaaaaaaaaaaaaaaaaaaaaaaaaaaaaaaaaaaaaaaaa
aaaaaaaaaaaaaaaaaaaaaaaaaaaaaaaaabbbbbbbbaaaaaaaaa
aaaaaaaaaaaaaaaaaaaaaaaaaaaaaaaaabbbbbbbbaaaaaaaaa
aaaaaaaaaaaaaaaaaaaaaaaaaaaaaaaaabbbbbbbbaaaaaaaaa
aaaaaaaaaaaaaaaaaaaaaaaaaaaaaaaaabbbbbbbbaaaaaaaaa
aaaaaaaaaaaaaaaaaaaaaaaaaaaaabbbbbbbbbbbbaaaaaaaaa
aaaaaaaaaaaaaaaaaaaaaaaaaaaaaaaaaaaaaaaaaaaaaaaaaa
"}
